#################
#P#........#O#OF#
#.#.T......#.#..#
#.#....F...#.#..#
#.#....O...#.#..#
#.#......T.#B#..#
#.#..T.....#.#..#
#K#.....K..#.#..#
#.#........#E#..#
#D########D#.#..#
#.....####.#.#..#
#..E..####I#.#..#
#...BO####...##X#
#################
